XXXXXXXX
X      X
X X XXXX
X X    X
XXXXXX X
XSXX X X
X    XEX
XXXXXXXX
