XXXXXXXX
XE     X
X X XXXX
X X    X
XXXXXX X
X XX X X
X    XSX
XXXXXXXX
